#######################################################
#   #    #                                            |
#   #MM# #            M      M                        |
#   #  # #              ###########    M              #
#   #  # #                                            #
#   #  # #                   M    #                   #
#   M  # #                        #                   #
######## #############            #                   #
       #                   M      #    M              #
       ###############            #                   #
         #                        #                   #
         #             M     M    #                   #
         #                        #                   #
         #                                            #
         #                #########   M               |
         #                                            |
         ##############################################