####################
#   #              |
#   #              |
#   ############## #
#   #          #   #
### ###### ### ### #
#   #   #  #    #  #
#   # # #  #    #  #
#  MM #    #       #
####################