#############################################################
#         #         #      #                     #          |
#    #    #    #    #      ###############  #    #          #
#    #    #    #                            #    #########  #
#    #      M  #    #      #                #               #
#############################################################