####################
#       #          #
#       #  #       #
#       #  #       #
#       #MM#       #
#       #  #       #
#       #  #       #
# #######  #       |
#          #       |
####################