#######################################
#      #       #                      #
#      #     #  #         ########### #
#      #  M #    ####     #           #
#      #   #   M    #     #           #
#      #   #    ## ####   #    ########
#      #  #     #     #   #           |
#      # #      #     #   #           |
#         #     #         #           |
#######################################