####################
#          #       #
#          #       |
#          #       #
#          #       #
#          #       #
#  M   M   #       #
#          ####### #
#                  #
####################